000000000000000000000000000000
000000000000000000000000000000
000000000000000000000000000000
222220000000000000000000000000
000000000000000000222000000000
000000000000000000000002222000
000000000022200000000000000000
000000000000000000000000000000
000000000000000000000000000000
000000000000000000000022200000
000000000000000000000000000000
000000000000000000000000000000
000000000000000000222000000000
000000000000000000000000000000
0000000000000G0000000000000000
000000000000063700000000000000
000000000000084900000000000000
000000002220084900000000000000
E0000000000008490000H000000000
3333333333333J4KOOOOOOOOOOOOOO
444444444444444444444444444444
