00000000000000000000000000000080000000000000000000
00000000000000000000000000000080000000000000000000
00000000000000000000000000000080000000000000000000
00000000000000000000000000000080000000000000000000
00000000000000000000000000000080000000000000000000
00000000000000000000000000000080000000000000000000
00000000000000000000000000000080000000000000000000
00000000000000000000000000000080000000000000000000
00000000000000000000000000000080000000000000000000
00000000000000000000000000000080000000000000000000
00000000000000000000000000000080000000000000000000
00000000000000000000000000000080000000000000000000
00000000000000000000000000000080000000000000000000
00000000000000000000000000000080000000000000000000
00000000000000000000000000000080000000000000000000
00000000000000000000000000000080000000000000000000
00000000000000000000000000000080000000000000000000
00000000000000000000000000000080000000000000000000
333333333333333333333333303333J4444444440000000000
44444444444444444444444440444444444444440000000000
44444444444444444444444440444444444444440000000000
44444444444444444444444440444444444444440000000000
44444444444444444444444440444444444444440000000000
44444444444444444444444440444444444444440000000000
44444444444444444444444440444444444444440000000000
44444444444444444444444440444444444444440000000000
44444444444444444444444440444444444444440000000000
44444444444444444444444440444444444444440000000000
44444444444444444444444440444444444444440000000000
44444444444444444444444440444444444444440000000000
44444444444444444444444440444444444444440000000000
00000000000444444444444440444444444444440000000000
00000000000444444444444440444444444444440000000000
00000000000444444444444440444444444444440000000000
00000000000444444444444440444444444444440000000000
00000000004444444444444440000000000000000000000000
00000000000444444444444440000000000000000000000000
00000000000000444444444440000000000000000000000000
00000000000000400004444440000000000000000000000000
00000000000000400404444440000000000000000000000000
00000000000004000444444440000000000000000000000000
00000000000000000444444440000000000000000000000000
00000000000000000004444440000000000000000000000000
00000000000000000044444440000000000000000000000000
00000000000000000044444440000000000000000000000000
00000000000000000044444440000000000000000000000000
00000000000000000004444440000000000000000000000000
00000000000000000004444440000000000000000000000000
00000000000000000004444440000000000000000000000000
00000000000444444444444440000000000000000000000000
00000000000444444444444444444444444444444000000000&
1 800 576 32 32 2
1 256 544 32 32 3
2 1056 1472 32 32 511