00000000000000000000000000000080000000000000000000
00000000000000000000000000000080000000000000000000
00000000000000000000000000000080000000000000000000
00000000000000000000000000000080000000000000000000
00000000000000000000000000000080000000000000000000
00000000000000000000000000000080000000000000000000
00000000000000000000000000000080000000000000000000
00000000000000000000000000000080000000000000000000
00000000000000000000000000000080000000000000000000
00000000000000000000000000000080000000000000000000
00000000000000000000000000000080000000000000000000
00000000000000000000000000000080000000000000000000
00000000000000000000000000000080000000000000000000
00000000000000000000000000000080000000000000000000
00000000000000000000000000000080000000000000000000
00000000000000000000000000000080000000000000000000
00000000000000000000000000000080000000000000000000
00000000000000000000000000000080000000000000000000
333333333333333333333333303333J4444444440000000000
44444444444444444444444441444444444444440000000000
44444444444444444444444441444444444444440000000000
44444444444444444444444441444444444444440000000000
44444444444444444444444441444444444444440000000000
44444444444444444444444441444444444444440000000000
44444444444444444444444441444444444444440000000000
44444444444444444444444441444444444444440000000000
44444444444444444444444441444444444444440000000000
44444444444444444444444441444444444444440000000000
44444444444444444444444441444444444444440000000000
44444444444444444444444441444444444444440000000000
44444444444444444444444441444444444444444444444444
00000000000444444444444441444444444444444444444444
00000000000444444444444441444444444444444444444444
00000000000444444444444441444444444444444444444444
00000000000444444444444441444444444444444444444444
00000000004444444444444441111111111111111111111111
00000000000444444444444441111111111111111111111111
00000000000000444444444441111111111111111111111111
00000000000000400004444441111111111111111111111111
00000000000000400404444441111111111111111111111111
00000000000004000444444441111111111111111111111111
00000000000000000444444441111111111111111111111111
00000000000000000004444441111111111111111111111111
00000000000000000044444441111111111111111111111111
00000000000000000044444441111111111111111111111111
00000000000000000044444441111111111111111111111111
00000000000000000004444441111111111111111111111111
00000000000000000004444441111111111111111111111111
00000000000000000004444441111111111111111111111111
00000000000444444444444441111111111111111111111111
00000000000444444444444444444444444444444444444444&
1 800 576 32 32 2
1 256 544 32 32 3
2 1248 1440 32 32 511
2 800 608 32 32 300
2 150 150 32 32 255