000000000000000000000000000000
000000000000000000000000000000
000000000000000000000000000000
000000000000000000000000000000
000000000000000000000000000000
000000000000000000000000000000
000000000000000000000000000000
000000000000000000000000000000
000000000000000000000000000000
000000000000000000000000000000
000000000000000000000000000000
000000000000000000000000000000
000000000000000000000000000000
000000000000000000000000000000
000000000000000000000000000000
000000000000000000000000000000
000000000000000000000000000000
000000000000000000000000000000
333333333333333333333333303333
444444444444444444444444404444
444444444444444444444444400000
444444444444444444444444400000
444444444444444444444444400000
444444444444444444444444400000
444444444444444444444444400000
444444444444444444444444400000
444444444444444444444444400000
444444444444444444444444400000
444444444444444444444444400000
444444444444444444444444404444
444444444444444444444444404444&
1 800 576 32 32 2
1 256 544 32 32 3
