0000000000000000000000000000000
0000000000000000000000000000000
0000000000000000000000000000000
0000000000000000000000000000000
0000000000000000000000000000000
0000000000000000000000000000000
0000000000001000000000000000000
0000000000000000000000000000000
0000000000000000000000000000000
0222220000000000000I00000000000
0000000000000000000222000000000
0000000000000000000000002222000
0000000000022200000000000000000
0000000000000000000000000000000
000000000000000000000000H000000
0000000000000000000000022200000
0000000000000000000000000000000
0000000000000000000000000000000
0000000000000000000222000000000
0000000000000000000000000000000
00000000000000G0000000000000000
0000000000000063700000000000000
0000000000000084900000000000000
0000000002220084900000000000000
0E0000000000008490000H0000000E0
33333333333333J4KOOOOOOOOOOOOOO
1111111111111111111111111111111&
0 64 224 64 64